{
   "scaling_factor": 20,
   "walling": [
      "333333333333333333333333333333333333333333333",
      "300000000000000000000000000000000000000000003",
      "300000000000000000000000000000000000000000003",
      "300000000000000000000000000000000000000000003",
      "300000000000000000000000000000000000000000003",
      "300000999999999999000000000999999999999000003",
      "300000900000000009000000000900000000009000003",
      "300000900000000009000000000900000000009000003",
      "300000900000000009000000000900000000009000003",
      "300000900000000000000000000000000000009000003",
      "300000900000000000001111100000000000009000003",
      "300000900000000000000000000000000000009000003",
      "300000900000000009000000000900000000009000003",
      "300000900000000009000000000900000000009000003",
      "300000900000000009000000000900000000009000003",
      "300000999999999999000000000999999999999000003",
      "300000000000000000000000000000000000000000003",
      "300000000000000000000000000000000000000000003",
      "300000000000000000000000000000000000000000003",
      "300000000000000000000000000000000000000000003",
      "333333333333333333333333333333333333333333333"
   ]
}