{
   "scaling_factor": 20,
   "walling": [
      "444444444444444444444444444444444444444444444",
      "400000000000000000000000000000000000000000004",
      "400555500000000000000000000000000000005555004",
      "400000500000066000000000000000066000005000004",
      "400555500000066000000000000000066000005555004",
      "400000000000000000000000000000000000000000004",
      "400000000008888888880000088888888000000000004",
      "400000000008000000000000000000000800000000004",
      "400000000008000000000000000000000800000000004",
      "400000000008000000022222222200000800000000004",
      "400000000000000000020000000200000000000000004",
      "400000000008000000022222222200000800000000004",
      "400000000008000000000000000000000800000000004",
      "400000000008000000000000000000000800000000004",
      "400000000008888888880000088888888000000000004",
      "400000000000000000000000000000000000000000004",
      "400555500000066000000000000000066000005555004",
      "400000500000066000000000000000066000005000004",
      "400555500000000000000000000000000000005555004",
      "400000000000000000000000000000000000000000004",
      "444444444444444444444444444444444444444444444"
   ]
}

